Name,Alignment,Intelligence,Strength,Speed,Durability,Power,Combat,Total
Spider-Man,good,88,55,60,74,58,85,420
Iron Man,good,100,85,58,85,100,64,492
Thor,good,69,100,92,100,100,85,546
Wolverine,good,55,32,38,100,44,100,369
Captain America,good,63,19,35,56,46,100,319
Deadpool,neutral,50,15,30,100,100,100,395
Doctor Strange,good,100,10,12,84,100,60,366
Hulk,good,88,100,47,100,41,85,461
Black Panther,good,88,16,30,60,41,100,335
Black Widow,good,75,13,27,32,32,100,279
